15 30
..............................
..............................
..............##..............
..............##..............
..............##..............
..............##..............
..............##..............
..............##..............
..............##..............
..............##..............
..............##..............
..............##..............
..............##..............
..............##..............
..............##..............
..............##..............
..............##..............
..............##..............
..............##..............
..............##..............
..............##..............
..............##..............
..............##..............
..............##..............
..............##..............
..............##..............
..............##..............
..............##..............
..j+u-m-p-s-..##........**....
..............##..............