15 15
........##........####........
..**....##h-o+l-l-y-##....**..
........##..........##........
........####........####......
................##............
............####..............
##..........................##
########..............########
##..........................##
..............####............
............##................
......####........####........
........##..........##........
..**....##..........##....**..
........####........##........