15 15
........##..........##........
..**....##..........##........
....................##........
..........##........##........
............##..l-u-d-u-m-####
######....r-..######a-........
........##o-....c-a-r-##......
......##..a-....a-..e-##......
......##..d-r+i-v-e-##........
..........######e-......######
####............##............
........##........##..........
........##....................
......**##..........##........
........##..........##....**..