15 15
**..........................**
..............................
....######..........######....
....##..................##....
....##..................##....
..............................
..............................
..........s-t-a+r-t...........
..............................
..............................
....##..................##....
....##..................##....
....######..........######....
..............................
**..........................**
