9 9
##..............##
........**........
..................
....l-u-d+u-m-....
........a-........
........r-........
........e-........
..................
##..............##