5 5
f+i-v-e-..
i-........
v-....##..
e-..##....
........**